12 5
100000000001
101010101011
100000000001
100000000001
111111111111